s|||7JLF7
777777777
777   777
7777|7777
7777L7777
777777777
7777|7777
77------g
